111111111111
10000S000001
100000000001
100100001001
100000000001
100000000001
100100001001
100011110001
100000000001
100000000001
111111111111
